11111111111111111111111111
10000000000000000000000C01
10000111001110111011100001
1P000101000010001010100001
10000001001110111000100001
100000C1C0001E001000100001
10000011101110111000100001
10000000000000000000000C01
11111111111111111111111111
