11111111111111111111111111
1D0000000000C0000000000001
10000111001110111011100001
1P000101000010001010100001
1000000100111E11100010C001
100000C1C00010001000100001
10000011101110111000100001
10000000000000000000000C01
11111111111111111111111111